11111111111111111111111111111
10000000001000100000001000001
11111111101010111110111011101
10001000001010000010100010001
10111011111011111010101110111
10000010000010100010000010001
10111110111010101111111110101
10000010001010001000000010101
11111011111010111110111011101
10001010000010100000101010001
10101010111110101111101010101
10101000100010001000101010101
10101111101011111010101010101
10100000101000000010101000101
10111110111110111110101111101
10001000000010101000000010001
10101111111010101011111110111
10101000001000100000100000101
10101011101111111111101111101
10100000100000000000000000001
11111111111111111111111111111